1111111111111
1111TU11111C1
11111111111C1
1P1C1111E1111
1111111111111