1111111111111
11111111111C1
11111111111C1
1P1C1111E1111
1111111111111