1111111111111
1010000100001
1000000100001
1000110000001
1000000000001
1000000000001
1111111111111