111111111111111
101000000000001
100000010101001
100011000000001
100000001000001
100000000000001
111111111111111