1111111111
1E000000C1
1P0CC00001
1001100T01
1U000000C1
1000000001
1000000001
1111111111
